10
17
17
xxxxxxxxxxxxxxxxx
b..e......x....bx
x.xxx.x.xxx.x.xxx
x.....x.....x...x
x.x.xxx.xxx.xxx.x
x.x.......x.....x
x.xxx.xxx.x.xxx.x
x...x.x....e....x
xxx.x.x.x.xxxxxxx
xbx.....x...xb..x
x.x.xxx.xxx.xxx.x
x....e....x.....x
x.xxxxxxxxxxxxx.x
x...x...x.....x.x
x.x.x.x.x.xxx.x.x
x.x...x.....x....
xxxxxxxxxxxxxxxxx
