10
17
17
xxxxxxxxxxxxxxxxx
..........x.....x
x.xxx.x.xxx.x.xxx
x.....x.....x...x
x.x.xxx.xxx.xxx.x
x.x.......x.....x
x.xxx.xxx.x.xxx.x
x...x.x.........x
xxx.x.x.x.xxx.xxx
x.x.....x...x...x
x.x.xxx.xxx.xxx.x
x.........x.....x
x.xxxxxxxxxxxxx.x
x...x...x.....x.x
x.x.x.x.x.xxx.x.x
x.x...x.....x....
xxxxxxxxxxxxxxxxx
